Level 28: The Chimera
9
9
0

00000000000000000000
066s.66666366....6r0
066..6666b366.3333.0
066......63.....6660
0..................0
066.......3...3.3330
066.......3.....3330
066......v3666..6660
066.......36663.6660
066.......3333333330
0444444444.........0
0004444444.........0
0g04444444.........0
0.4444444<..o.....v0
0.44444444......0QQ0
0.44444444......0WW0
0.04444444......0AA0
0004444444......0ZZ0
0444444444......0.f0
00000000000000000000


