Level 13: Incoming Robot Train
5
6
0

00000000000000000000
05555555555555555550
05555555555555555550
0s..........v....550
0................550
0................550
0................550
0......v....b....550
0................550
05555551555555555550
01111111111111111550
0................550
0................550
00000000....55555550
0.B.........55555550
0fB.........55555550
0.B.........55555550
000.........55555550
000.........55555550
00000000000000000000

