Level 10: The Swim Bot
2
5
1
The Swim Bot walks in a line swimming through any water in its way.
00000000000000000000
055555..s..555555550
055555.....555555550
055555.....555555550
055555.....555555550
055555.....555555550
055555.....555555550
055555.....5555r.b.0
055555.....5555....0
055555.....555555550
0.g.55.....555555550
055555.....555555550
055555.....555555550
055555.....555555550
055555.....555555550
0555550QQQ0555555550
0555550AAA0555555550
0555550WWW0555555550
0555550.f.0555555550
00000000000000000000

