Level 17: They're Everywhere!
4
6
0

00000000000000000000
0..11....s....444..0
0..11.........444..0
0..11..>....v.444..0
0..11}........444..0
0..11........{444..0
0..11}........444..0
0..11........{444..0
0..11....{....444..0
0..11..^.{..<.444..0
0..11..>....v.444.{0
0..11.........444..0
0..11.........444..0
0..11].}......444..0
0..................0
0........].........0
0......^....<......0
0..................0
0........f.........0
00000000000000000000

