Level 27: More Tricks
4
9
0

00000000000000000000
0.0......s.......0.0
0.0..............0r0
063.........{....360
063..............360
063..............360
06666666666666666660
066............00000
066............0...0
066............0g].0
066............0...0
066............33330
066............36660
066............36660
066............36660
066............33330
066....0QQQ0...36660
066....0WWW0...36660
066....0.f.0...36660
00000000000000000000
