Level 30: The Final Challenge
10
9
0

00000000000000000000
0666666..s......R..0
06r6666.........Rb.0
06.1.33.........0000
06.111..........0550
0.....3........^0550
03...33.........0550
0333333.........0550
0........>......0550
0...............0550
0..v...<........0550
04444444........0550
04444444.v.....<0550
0..............^0550
0..v....<.......0550
0..3........55555550
0AAAAAA0ZZZ055555000
06666660...055555G.0
06.w.660.f.05.>..Go0
00000000000000000000
