Level 11: Time is Money
5
5
0

00000000000000000000
0...s...055555555550
0.......000000000550
0...............0550
0...............0550
0555555555555...0550
0555555555555...0550
0.......55555...0550
0...r...55555...0550
0.......55555...0550
0.......55555..b0550
0555555555555...0550
0...............0550
0...............0550
0...............0550
0...............0550
000QQQ00000000000550
050AAA05555555555550
050.f.05555555555550
00000000000000000000

