Level 02: The Bomb Bot
2
2
1
Bots other than the Redirection Bot launch off the train in the direction you click. Remember, your highlighted Generic Bots won't take on the properties of other Bots until launched.
00000000000000000000
06666666666666666660
06666666666666666660
06666666666666666660
06666666666666666660
06666666666666666660
06666666666666666660
06666666666666666660
06666666666666666660
0s..........66666660
0...........66666660
0...........66666660
0...........66666660
0...........66666660
0......0111066666660
0......0111066666660
0......0...066666660
0......0.f.066666660
0......0...066666660
00000000000000000000

