Level 26: Arrows and Blocks
5
9
0

00000000000000000000
0...........44444440
0....>......44444440
0..........344444440
03...>......444q4440
0.....3.....44444440
0...........44444440
0...........44444440
0...........44444440
0...........44444440
0^........3........0
0.....3.........3..0
0..................0
0..........>..v....0
0..............^...0
0...^.............s0
0.......3......00000
0..............R...0
0......>...^..>R..f0
00000000000000000000

