Level 12: The Drill Bot
3
6
1
The Drill Bot walks in a line destroying any drillable terrain in its way.
00000000000000000000
0s...44444v444444440
0....444444444444440
0....444444444444440
04444444444444444440
04444444444444444440
0444444444444444...0
0.r..44444444444.b.0
0....44444444444...0
0....44444444444...0
0....44444444444...0
0444444444444444...0
0444444444444444...0
0444444444444444...0
0444444444>44444...0
0.......00000......0
0.......R...B......0
0.......R...B......0
0..>....R.f.B...<..0
00000000000000000000

