TestLevel
6
00000000000000000000
0..................0
0..................0
0..................0
0....v.....g..<....0
0..................0
0..................0
0....b.............0
0.............r....0
0..................0
0....>.o.f..s.^....0
0..................0
0RRRRRRRRRRRRRRRRRR0
0..................0
0GGGGGGGGGGGGGGGGGG0
0..................0
0BBBBBBBBBBBBBBBBBB0
0..................0
0OOOOOOOOOOOOOOOOOO0
00000000000000000000

